######
#    #
# $ .#
# $ .#
#    #
#   @#
######