##########
#   #    #
# $ #    #
#   #.   #
#   ### ##
#       # 
#@      # 
######### 