       #####
########   #
#.         #
#####  ##  #
    #  #.  #
  ###  #####
  #    #    
  #    #    
###  ####   
#   $$  #   
#@      #   
#########   