 ####          
 #  ###########
 #            #
 # #########  #
 # ##  ##### ##
 # ##    $@# # 
 # ## ###### # 
 # #  ###### # 
## #         # 
#  ########  # 
#        .#### 
###########    