          ####                
          #  #    #####       
          #  #    #   #       
          #  ######$# ##      
       #### $  $       #      
       #     ####$##$$ #      
       # ##$##  #  $ $ #      
       #   $    #$ # # #      
       ####$###.#  ..# #####  
       # $  $ #.##$#.# #   #  
    #### ## #  ... #..     #  
    #..  $  $ #### ### #####  
    #.#$### #$ $ $   ..#   #  
#####.#     $ $#.# ###.# # #  
#   #.# # #.#  ...   ..#   ###
#   $   #$#.####.#######     #
# $ # # # ... $  # .....     #
# $  $  #$####$# # # #####   #
### $ $$ $     # # #$$   #####
  ##$## ## # $## $ $   $$  $@#
   #  ..## #$ ## #.##  $ $ # #
   # #...    ##  .... #$ #$$ #
   #$# ###.#.## #####$#    ###
   #   ##..#... ##...    $ #  
   ## $ ..###.#  ..#####   #  
    #$# #     ## ###   #####  
    #   # ###$$   $ $# #      
    #####     #  # $   #      
        ##########   ###      
                 #####        