       #####
########   #
#.         #
#####  ## @#
    #  #.  #
  ###  #####
  # $$ #    
  #    #    
  ######    