     ######      
 #####    ####   
 #   #$$     #   
 # #   $$ ## ##  
 #    ##  ##  ## 
 # ## #####    # 
##     #### ## ##
#  # #   ## ..  #
#         ## .. #
####  ##     ####
   ##  # # # #   
    ##  @    #   
     #  #  ###   
     #######     